8 9 9 9 9 9 9 9
9 8 9 9 8 9 8 9
9 9 9 9 9 9 8 9
9 9 9 9 9 9 9 8
8 9 9 8 9 9 9 8
8 9 9 9 9 8 8 9

0 0 0 0 3 1 2 3
3 3 2 1 1 1 2 2
0 1 3 1 2 0
0 2 0 0 3 0

50 50 50 50