8 9 8 8 9 9 9 8
9 9 9 9 9 8 8 8
8 9 9 9 8 8 9 8
8 9 8 9 9 9 9 8
9 9 9 9 9 9 9 9
8 8 9 8 9 8 9 9

1 3 2 3 1 3 2 3
2 1 2 0 1 0 3 1
0 0 1 3 2 0
0 0 0 0 2 0

50 50 50 50