8 8 8 8 9 8 9 8
9 8 8 8 8 8 9 8
8 8 8 8 8 8 9 8
8 8 9 9 8 9 8 8
8 8 8 8 9 8 8 8
8 8 8 8 8 8 9 8

3 2 0 0 0 0 0 1
0 0 0 0 3 2 1 0
0 1 0 0 0 0
0 0 0 0 1 0

25 8 2 4
