8 8 9 8 8 8 9 9
8 9 8 8 8 8 8 8
8 8 9 9 8 9 8 9
8 8 8 8 8 9 9 8
8 8 9 9 8 9 8 8
8 9 9 8 8 8 9 8

3 0 0 0 0 0 0 2
0 0 1 0 0 1 0 0
0 1 2 1 2 0
0 0 3 0 2 0

12 12 2 5
