9 8 8 8 8 9 8 8
8 9 9 8 9 8 9 8
8 9 8 8 8 9 8 9
9 9 8 8 8 8 9 9
9 8 9 8 9 8 8 8
9 8 9 9 8 9 9 9

1 0 0 0 2 3 1 0
0 0 0 2 0 0 2 0
0 2 0 3 1 0
0 0 0 0 1 0

20 10 2 12
