9 8 9 9 9 8 9 8
9 9 9 9 9 9 9 9
9 9 9 9 9 8 9 9
8 9 9 8 8 9 9 9
9 9 8 9 9 8 9 8
8 9 8 8 9 9 9 9

0 1 2 2 2 0 0 3
2 3 3 0 0 0 0 0
0 2 3 0 2 0
0 1 0 0 0 0

18 18 2 23
