9 9 9 9 8 9 8 9
9 9 8 9 8 9 9 9
9 8 9 9 8 8 8 9
8 8 9 9 9 8 9 9
9 9 9 9 9 8 8 9
9 9 9 9 9 8 9 8

2 3 2 3 0 0 0 1
0 0 3 3 2 0 0 0
0 2 2 1 0 0
0 2 0 0 0 0

10 20 1 18
