9 8 9 9 8 9 9 9
8 9 8 8 9 9 8 9
8 8 8 9 9 9 8 9
8 9 9 8 9 9 9 8
8 8 8 9 9 8 8 9
8 9 8 8 8 9 9 9

0 1 3 2 3 0 0 0
0 0 2 2 2 0 2 0
0 0 0 2 0 0
0 3 1 0 3 0

10 15 3 11
