9 8 8 9 9 8 9 9
9 8 9 9 8 9 8 8
9 8 9 9 9 9 8 9
9 9 9 9 9 9 8 9
9 9 8 8 8 8 9 9
9 9 9 9 9 9 9 9

3 0 2 3 0 3 2 2
1 2 1 1 2 3 2 3
0 1 3 1 0 0
0 0 0 1 0 0

16 16 3 24
