9 9 8 8 9 9 8 9
9 9 9 9 8 8 9 9
9 8 9 9 9 9 9 9
9 8 8 8 9 9 8 9
9 9 9 9 9 9 9 8
9 8 9 9 9 9 8 9

2 3 0 2 2 3 2 1
1 1 2 0 0 1 1 0
0 3 2 3 3 0
0 0 1 0 3 0

10 18 2 21
