8 8 8 9 8 8 8 8
8 8 8 9 8 9 8 8
8 9 9 8 8 8 8 8
8 8 8 8 8 9 8 8
8 8 8 8 8 8 8 8
8 8 8 9 8 8 9 8

0 0 0 0 1 0 1 0
0 0 2 0 0 0 0 0
0 0 0 0 2 0
0 0 0 0 0 0

4 3 0 0
