9 9 8 9 8 8 9 8
8 8 8 8 8 8 8 8
9 8 8 9 9 8 8 9
9 8 9 8 8 9 9 9
9 8 9 9 8 9 9 9
8 9 9 9 9 8 9 9

0 2 0 2 1 2 0 2
1 3 0 1 1 3 0 0
0 0 0 0 0 0
0 0 0 0 0 0

50 50 50 50