8 8 8 8 8 8 8 8
9 8 8 8 8 8 8 9
8 8 8 8 8 8 8 8
8 8 9 8 9 8 8 8
9 9 9 8 8 8 8 8
8 8 9 9 8 8 8 8

2 0 0 0 0 0 0 0
0 0 0 1 0 0 0 2
0 0 0 0 0 0
0 1 0 0 0 0

50 50 50 50