8 8 9 9 9 9 9 9
9 8 9 9 9 8 9 9
9 9 9 9 9 9 9 9
9 9 9 8 9 9 9 9
8 9 8 8 9 9 9 8
9 9 9 9 8 8 9 9

2 2 3 1 0 2 2 0
3 3 3 0 2 3 1 1
0 0 1 1 2 0
0 0 1 3 0 0

50 50 50 50