9 8 8 8 8 8 8 8
9 8 8 8 8 8 8 8
8 9 8 8 8 8 8 9
8 9 8 8 9 8 9 8
8 8 9 8 8 8 9 8
8 8 8 8 8 8 9 9

3 0 0 2 0 0 0 0
0 0 3 0 0 1 0 1
0 1 0 0 1 0
0 0 0 2 0 0

14 14 0 5
