8 9 9 9 9 8 9 8
9 9 8 9 8 8 8 9
9 8 9 8 8 8 9 8
9 8 8 9 8 8 9 9
9 9 8 9 9 8 8 9
9 9 8 9 9 8 9 9

0 0 0 1 2 0 0 3
3 0 0 0 0 0 1 1
0 0 2 0 2 0
0 0 0 2 1 0

20 20 2 16
