8 9 9 9 8 9 8 8
9 8 8 8 9 8 8 8
8 8 8 9 9 8 9 9
9 9 9 8 8 8 8 9
9 8 8 8 9 9 9 8
8 8 8 9 8 8 8 9

0 2 1 0 0 2 1 1
2 3 1 0 0 0 0 0
0 0 0 0 0 0
0 0 0 3 2 0

20 10 2 10
