8 9 8 8 9 8 8 9
8 9 9 9 9 8 8 8
8 8 9 9 8 8 8 9
8 8 8 9 9 8 9 9
9 8 9 8 8 9 9 9
9 9 9 8 8 9 8 8

1 0 0 0 0 0 2 0
0 1 0 3 0 3 2 0
0 0 0 0 1 0
0 0 2 1 2 0

20 15 0 9
