8 9 8 8 8 9 9 9
8 8 9 8 8 8 8 8
8 9 8 9 8 8 8 8
8 8 8 8 8 8 8 8
9 8 8 8 8 8 9 8
9 8 9 8 9 8 8 8

0 0 0 0 0 2 0 0
0 0 2 0 0 0 0 0
0 0 1 0 0 0
0 1 0 0 0 0

10 10 1 2
