8 8 8 9 9 8 9 9
8 9 8 9 8 9 9 9
9 9 9 9 9 8 8 9
9 9 9 9 9 9 9 8
9 8 9 9 9 9 9 9
9 9 8 9 9 8 9 8

1 1 0 0 2 0 0 3
3 0 0 0 0 3 2 3
0 0 0 0 2 0
0 2 2 2 0 0

20 10 3 20
