9 9 9 9 9 8 8 9
9 8 8 8 9 9 9 9
9 9 8 9 8 9 8 9
8 8 8 8 8 9 9 8
8 9 8 9 8 8 8 9
9 8 8 9 9 8 9 8

0 2 0 2 0 2 0 0
0 2 3 0 0 0 3 2
0 3 1 0 0 0
0 0 3 2 1 0

20 15 5 12
