9 9 9 9 9 8 8 9
9 9 8 8 8 9 9 9
8 9 8 8 9 9 9 9
9 9 9 9 8 8 8 8
8 9 9 9 9 9 9 8
9 9 9 8 9 9 9 9

2 3 2 2 1 2 1 0
1 3 3 2 3 1 3 0
0 1 3 0 0 0
0 2 0 0 1 0

18 14 4 23
