9 9 9 8 9 9 8 8
8 9 8 8 8 9 9 9
9 9 9 9 9 9 9 8
9 8 9 8 9 9 9 8
9 9 8 9 8 9 9 8
9 9 9 8 8 8 9 9

3 0 1 0 3 2 3 2
2 1 1 2 0 0 3 2
0 3 1 1 3 0
0 0 0 1 2 0

17 25 10 22
