9 9 9 9 8 8 9 9
8 9 9 8 9 8 8 9
9 8 8 9 8 9 9 8
9 9 9 9 8 8 9 9
9 9 9 9 9 9 9 9
9 9 9 9 9 9 9 8

3 1 3 2 1 1 0 0
1 2 2 3 0 0 2 1
0 0 1 3 3 0
0 0 2 2 3 0

15 20 8 25
