8 8 8 8 8 8 8 8
8 8 8 8 8 8 8 8
1 1 8 8 8 8 1 1
8 8 8 8 8 8 8 8
8 8 8 8 8 8 8 8
8 8 8 8 8 8 8 8

0 0 0 0 0 0 0 0
0 0 0 0 0 0 0 0
0 0 3 0 0 0
0 0 3 0 0 0

0 0 0 0
