8 9 9 8 8 8 8 8
9 8 9 8 8 8 9 8
8 8 8 8 8 8 8 8
8 8 8 8 8 9 8 8
8 9 8 8 8 8 9 8
9 9 8 8 9 9 8 9

0 0 0 0 1 0 0 3
1 0 1 1 0 0 0 0
0 0 2 2 0 0
0 0 0 0 3 0

10 10 0 2
