9 9 8 9 8 9 9 8
9 8 8 9 9 9 9 8
8 9 8 8 9 8 8 8
8 9 8 9 8 8 8 9
9 8 8 9 8 8 8 9
8 9 8 9 8 9 9 8

0 3 0 0 1 0 1 0
1 0 0 0 0 0 0 1
0 3 0 2 2 0
0 0 0 0 0 0

13 15 0 7
