9 8 9 8 8 9 8 8
8 9 9 8 9 8 8 8
8 9 8 9 9 8 8 8
9 8 9 9 8 9 8 9
9 9 8 9 9 9 8 9
8 9 9 9 8 9 8 9

0 2 0 1 3 1 1 2
0 0 0 0 0 0 0 0
0 0 0 1 2 0
0 0 3 2 0 0

10 15 2 8
