8 9 9 9 9 9 9 9
9 9 8 9 9 9 9 8
9 9 8 8 9 8 8 9
9 9 8 9 8 9 8 8
9 9 9 9 9 8 9 9
8 8 8 9 8 9 9 8

0 2 1 1 0 3 0 0
0 0 1 2 2 0 1 0
0 2 0 0 0 0
0 0 0 0 3 0

5 15 5 12
