8 8 8 8 9 8 9 9
8 8 9 8 8 9 9 9
9 8 9 9 9 8 9 9
8 8 9 9 9 8 8 9
8 8 8 8 9 8 9 8
9 8 9 8 8 9 9 8

0 0 2 0 1 0 1 2
3 1 3 0 2 2 0 0
0 0 0 0 1 0
0 0 0 0 0 0

8 12 1 9
