8 8 9 9 8 8 8 9
9 8 8 8 9 9 8 9
9 9 8 9 9 8 9 8
8 9 8 8 9 8 9 8
9 9 8 8 8 9 9 8
9 8 8 8 9 9 8 9

2 0 0 0 0 0 0 1
1 2 0 0 0 1 3 2
0 0 3 0 0 0
0 2 1 0 0 0

16 16 3 14
