9 9 9 9 9 9 9 8
9 8 8 9 8 8 9 9
9 9 9 8 8 9 8 9
9 9 9 9 8 8 9 8
8 8 8 9 8 9 9 8
9 9 8 8 8 9 9 9

3 2 2 3 0 2 1 2
0 2 0 0 0 0 0 1
0 0 0 0 2 0
0 3 3 0 0 0

10 15 1 14
