9 9 9 8 9 9 8 9
8 9 9 9 8 8 9 9
9 8 9 8 9 8 9 8
8 9 9 9 9 9 8 9
9 8 9 9 9 8 8 9
8 8 9 9 9 8 8 8

1 0 3 0 0 0 2 1
0 0 3 3 0 0 3 0
0 0 2 2 0 0
0 2 2 2 0 0

10 5 2 15
