9 8 8 9 9 9 9 9
9 9 9 8 9 9 8 8
9 9 8 9 9 8 9 9
8 9 9 8 9 9 8 8
9 8 9 9 9 8 8 9
9 8 8 8 8 8 9 9

1 2 2 3 2 0 3 2
0 1 0 0 0 0 2 2
0 0 3 0 0 0
0 0 0 0 3 0

15 10 2 15
