9 8 9 8 9 9 8 8
9 9 8 9 9 8 9 9
8 8 9 9 8 9 9 8
9 9 9 8 8 9 9 8
9 9 8 9 8 8 9 9
8 9 9 9 8 9 8 9

0 0 1 0 0 0 2 0
0 2 3 0 0 2 2 1
0 0 0 3 3 0
0 2 2 0 3 0

15 20 2 20
