9 9 9 9 8 8 9 8
8 9 9 9 8 9 9 8
8 8 8 9 9 9 9 9
8 8 9 9 9 9 9 9
9 9 9 9 8 8 8 8
9 9 9 9 9 9 9 9

2 2 0 2 0 3 2 3
1 0 2 0 0 1 0 2
0 0 0 3 0 0
0 0 3 0 0 0

15 15 2 17
