8 9 9 9 9 9 9 9
9 8 9 9 9 9 8 9
9 8 8 8 9 9 9 9
8 9 8 8 9 9 8 8
9 9 9 9 9 9 9 9
9 9 8 9 8 8 9 8

0 3 0 2 1 3 2 2
3 0 1 0 1 2 0 2
0 1 3 1 3 0
0 3 1 2 0 0

20 15 1 22
