9 9 8 9 9 9 9 8
9 8 9 8 8 9 9 9
9 9 9 9 9 8 9 8
9 9 8 9 9 9 9 9
9 9 8 9 9 9 9 9
9 9 9 9 8 9 8 9

0 3 3 2 1 1 3 0
2 2 0 3 0 2 2 2
0 3 1 1 0 0
0 3 1 0 1 0

12 20 0 22
