8 9 9 9 9 9 8 8
9 9 8 9 9 9 9 9
9 9 9 8 9 9 9 9
9 8 8 8 9 8 9 8
9 9 9 8 9 9 8 8
9 8 9 9 9 9 8 9

2 0 1 0 3 1 2 2
3 1 2 3 2 0 0 3
0 2 0 1 1 0
0 3 3 1 0 0

20 15 4 22
