9 9 8 9 8 8 9 9
8 9 9 8 9 9 8 9
8 9 9 9 9 9 9 8
9 9 9 9 9 9 9 9
9 9 8 9 9 9 8 9
8 9 9 9 9 9 9 9

0 3 1 0 3 1 3 1
3 0 3 0 3 2 1 2
0 2 0 0 1 0
0 2 1 2 2 0

15 18 7 26
