8 8 8 8 8 8 8 8
8 8 8 8 8 8 8 8
8 8 8 8 8 8 8 8
8 8 8 8 8 8 8 8
8 8 8 8 8 8 8 8
8 8 8 8 8 8 8 8

0 1 0 3 0 2 0 0 
0 0 1 0 2 0 0 1
0 3 0 2 0 0
2 0 0 0 1 0

20 20 2 0