8 9 2 9 8 8 8 8
8 9 8 9 8 8 8 8
8 9 8 9 8 8 8 8
8 8 8 8 8 9 8 9
8 8 8 8 8 9 8 9
8 8 8 8 8 9 2 9

0 0 1 0 0 0 0 0
0 0 0 0 0 0 1 0
0 0 0 0 2 0
0 2 0 0 0 0

20 4 1 1