9 8 9 9 9 9 9 9
9 8 9 8 8 8 8 9
9 8 9 8 8 9 8 9
9 8 8 9 9 8 8 9
9 8 8 8 8 8 8 9
9 9 9 9 9 9 9 9

0 1 0 1 0 0 0 0
0 0 0 0 0 0 0 0
0 0 0 0 0 0
0 0 0 0 0 0

9 9 0 1