1 9 3 5 1 3 3 2
2 3 2 4 2 9 9 1
9 2 4 3 7 2 6 4
1 2 9 9 7 2 5 5
5 7 2 3 3 4 7 6
1 9 7 6 1 2 9 7

0 0 1 0 0 0 2 0
0 0 0 0 0 0 0 0
0 2 0 0 0 0
0 0 0 0 0 1

0 0 0 0