8 8 8 8 8 8 8 8
8 8 8 8 8 8 8 8
8 8 8 8 8 8 8 8
8 8 8 8 8 8 8 8
8 8 8 8 8 8 8 8
8 8 8 8 8 8 8 8

0 1 2 3 0 0 0 0
0 0 0 0 0 0 0 0
0 0 0 0 0 0
0 0 0 1 2 3

5 21 3 0