8 8 8 8 8 9 8 8
9 8 8 8 9 8 9 8
8 9 8 9 8 8 8 8
8 8 8 8 8 8 9 8
8 9 8 9 8 8 8 8
9 8 8 8 8 8 8 8

3 0 0 0 0 0 0 0
0 0 0 0 0 0 0 0
0 0 0 1 0 0
3 0 0 1 0 0

11 13 2 0