8 9 9 9 9 8 8 8
8 9 8 9 8 8 8 8
8 8 8 9 8 9 8 8
8 9 8 9 8 8 9 8
9 8 8 8 9 8 9 8
8 8 9 9 8 8 8 8

1 0 0 0 0 0 0 0
0 0 0 0 0 0 0 2
0 0 0 0 0 2
0 0 1 0 0 0

20 20 0 2