9 9 9 9 9 9 9 9
8 8 8 8 8 8 8 8
8 8 8 8 8 8 8 8
8 8 8 8 8 8 8 8
9 9 9 9 9 9 9 9
9 9 9 9 9 9 9 9

0 0 0 0 0 0 0 0
0 0 0 0 0 0 0 0
0 0 1 2 0 0
0 0 1 2 0 0

0 16 8 0