4 5 4 5 4 5 4 5
3 6 3 7 7 6 3 6
4 5 4 7 7 5 4 5
3 6 3 6 3 6 3 6
4 5 4 5 4 5 4 5
3 6 3 6 3 6 3 6

0 0 0 0 0 0 0 0
0 0 0 0 0 0 0 0
0 0 0 0 2 0
0 2 0 0 0 0

5 0 1 0