8 9 8 9 8 9 8 9
9 8 9 8 9 8 9 8
8 9 8 9 8 9 8 9
8 9 8 9 8 9 8 9
9 8 9 8 9 8 9 8
8 9 8 9 8 9 8 9

1 0 2 0 3 0 0 0
0 0 1 0 2 0 3 0
0 0 0 0 0 0
0 0 0 0 0 0

18 6 0 9