8 8 8 8 8 8 8 8
8 8 8 8 8 8 8 8
8 8 8 8 8 8 8 8
8 8 8 8 8 8 8 8
8 8 8 8 8 8 8 8
9 9 9 2 9 2 9 2

1 0 2 0 3 0 0 0
0 0 0 1 0 2 0 3
0 0 0 0 0 0
0 0 0 0 0 0

0 50 0 0