8 9 8 8 8 8 8 8
8 8 8 8 8 9 8 8
8 9 9 8 8 8 8 9
8 8 9 9 8 9 8 9
8 8 8 8 8 8 8 8
8 9 8 9 8 9 8 8

0 1 2 1 2 1 2 0
0 1 2 1 1 2 2 0
0 0 0 0 3 0
0 0 3 0 0 0

14 14 5 7