8 8 8 8 8 8 8 8
8 8 8 8 8 8 8 8
8 8 8 8 8 8 8 8
8 8 8 8 8 8 8 8
8 8 8 8 8 8 8 8
8 8 8 8 8 8 8 8

0 2 3 1 2 3 1 0
0 3 2 1 3 2 1 0
0 3 2 3 3 0
0 1 2 3 1 0

50 50 50 0