9 8 9 8 9 8 9 9
9 8 9 8 9 8 9 9
8 8 8 8 8 8 8 8
9 8 8 8 8 8 9 9
8 8 8 8 8 8 8 8
9 8 9 8 9 8 9 9

0 3 0 3 0 3 0 0
0 3 0 3 0 3 0 0
0 0 1 0 1 0
0 0 2 0 2 0

22 4 4 0