9 8 9 8 9 8 9 8
9 8 9 8 9 8 9 8
8 8 9 8 9 8 9 8
8 9 8 9 8 9 8 9
8 9 8 9 8 9 8 9
8 9 8 9 8 8 8 9

0 2 0 2 0 1 0 1
2 0 2 0 1 0 1 0
0 0 0 0 0 0
0 0 0 0 0 0

12 8 0 2