4 1 1 1 1 1 1 5
2 9 9 9 9 2 9 2
2 9 4 5 4 6 9 2
2 9 2 3 6 8 9 2
2 9 2 9 9 9 9 2
3 1 1 1 1 1 1 6

0 0 3 0 2 0 0 0
0 3 0 2 0 0 1 0
0 0 0 0 0 0
1 0 0 0 0 0

0 3 0 0