9 8 8 8 9 9 8 8
4 7 7 7 1 5 2 2
2 2 3 7 5 3 6 2
2 3 1 7 7 5 4 6
8 9 9 8 8 8 8 9
8 8 8 8 8 8 8 8

0 1 2 3 0 0 2 3
0 0 0 3 0 2 2 0
0 0 0 0 3 0
0 0 0 0 0 1

13 1 2 0