8 8 8 8 8 8 8 8
8 8 8 9 8 8 8 8
8 8 9 9 9 8 8 8
8 9 8 9 9 9 8 8
9 9 8 8 9 9 9 8 
9 9 8 8 8 9 9 9

0 0 0 0 0 0 0 0
0 0 0 3 0 0 0 0
0 2 0 0 0 0
0 2 0 3 0 0

12 11 0 2