4 1 1 1 1 1 1 1
2 4 1 1 1 1 1 1
2 2 4 1 1 1 1 1
2 2 2 4 1 1 1 1
2 2 2 2 4 1 1 1
2 2 2 2 2 9 9 9

0 0 1 0 2 0 3 0
0 0 0 0 0 0 0 0
0 1 2 3 1 0
1 0 0 0 0 0

0 0 0 0