4 4 1 5 4 1 5 5
2 2 7 2 2 9 2 2
2 8 8 4 5 8 8 2
2 9 9 9 9 9 9 2
2 8 9 2 2 2 8 2
3 8 8 9 9 8 8 6

0 0 0 0 0 0 0 0
0 0 2 0 0 2 0 0
1 0 0 0 0 3
3 0 0 0 0 1

1 2 0 1