8 8 8 8 8 8 8 8
8 9 1 5 8 8 8 8
8 9 8 2 8 9 9 8
8 9 8 2 8 9 9 8
8 8 8 9 8 8 9 8
8 8 8 8 8 8 9 8

0 0 0 1 0 0 0 0
1 0 0 0 0 2 0 0
2 3 0 0 1 0
0 0 1 0 0 3

14 12 1 2