8 8 9 8 8 9 8 8
9 8 9 9 9 8 9 9
8 8 8 9 8 9 9 8
8 9 8 8 9 8 9 8
8 8 9 9 8 9 8 9
9 9 9 9 8 8 9 8

0 1 0 3 0 2 0 0
0 0 2 0 3 0 0 1
1 0 3 0 2 0
0 1 0 2 3 0

16 8 2 10