8 8 8 8 8 8 8 8
8 8 8 9 8 9 8 8
8 9 8 8 8 8 8 8
8 8 8 9 9 8 8 8
8 8 8 9 9 8 8 8
8 8 8 8 8 8 8 8

0 1 2 3 2 3 1 0
0 1 3 2 1 3 3 0
2 1 2 3 1 2
1 2 3 3 2 1

20 20 10 1