8 8 8 8 8 8 8 8
8 8 9 8 9 8 8 8
8 8 8 8 8 8 8 8
8 8 8 8 8 8 9 8
8 8 8 8 9 8 9 8
8 8 8 8 8 8 8 8

1 2 3 2 3 1 2 3
1 3 2 1 3 2 3 1
0 2 1 3 2 0
0 2 1 3 1 0

16 18 9 0