8 8 8 8 8 8 8 8
8 9 8 8 9 8 8 8
8 8 8 8 8 9 8 8
8 8 9 8 8 8 9 8
8 8 8 8 9 8 8 8
8 8 9 8 8 8 9 8

1 0 0 0 0 0 0 3
3 0 0 0 0 0 0 1
0 0 0 0 0 0
0 0 0 0 0 0

15 15 1 0