9 9 9 9 9 9 9 9
9 9 9 9 9 9 9 9
9 9 9 9 9 9 9 9
9 9 9 9 9 9 9 9
9 9 9 9 9 9 9 9
9 9 9 9 9 9 9 9

0 0 1 2 3 0 0 0
0 0 2 3 1 0 0 0
0 0 0 0 0 0
0 0 0 0 0 0

50 50 2 50