8 8 8 8 8 8 8 8
8 8 8 8 8 8 8 8
8 8 8 8 8 8 8 8
8 8 8 8 8 8 8 8
8 8 8 8 8 8 8 8
8 8 8 8 8 8 8 8

0 2 1 0 0 2 0 0
0 0 0 0 2 0 0 0
0 0 3 1 3 0
0 0 0 0 2 0

99 99 99 99