8 8 8 8 8 8 8 8
8 8 8 8 8 8 8 8
8 8 8 8 8 8 8 8
8 8 8 8 8 8 8 8
8 8 8 8 8 8 8 8
8 8 8 8 8 8 8 8

0 2 1 2 0 1 2 0
0 0 1 3 0 1 3 0
0 0 2 0 0 0
0 0 0 0 0 0

99 99 99 99