9 9 9 9 8 8 8 9
9 8 9 9 8 8 8 8
8 9 9 8 8 9 9 9
9 9 9 9 9 8 9 9
9 8 9 9 9 9 9 8
8 8 9 9 8 9 8 9

0 3 0 3 3 0 2 2
0 0 1 2 2 2 3 0
0 0 0 0 0 0
0 0 0 2 1 0

50 50 50 50