9 9 9 9 9 8 9 9
8 8 8 8 8 9 9 8
9 9 9 9 9 9 9 9
9 8 8 8 8 9 9 9
8 9 9 8 9 9 9 9
9 9 9 8 9 8 8 8

1 0 0 1 2 3 1 3
3 0 0 0 2 2 2 3
0 3 0 2 1 0
0 2 1 1 3 0

50 50 50 50