8 9 9 8 9 9 8 8
8 9 9 8 9 8 8 9
9 9 8 8 9 9 9 9
9 9 9 9 8 8 9 8
9 9 8 9 8 9 8 9
9 9 9 8 9 8 8 8

0 2 2 3 0 2 3 1
0 3 3 2 3 2 0 1
0 3 2 1 1 0
0 1 0 1 0 0

50 50 50 50