8 8 8 8 8 8 8 8
8 8 8 8 8 8 8 8
8 8 8 8 8 8 8 8
8 8 8 8 8 8 8 8
1 1 1 1 8 1 1 1
8 8 8 8 8 8 8 8

0 0 0 0 0 0 0 0
0 0 0 0 0 0 0 0
0 0 0 0 2 0
0 0 0 0 2 0

99 99 99 99