8 8 8 8 8 8 8 8
8 8 9 9 8 9 8 8
9 9 9 9 8 8 9 9
9 8 8 8 8 8 9 9
9 8 9 9 8 9 8 8
9 8 9 9 9 8 8 8

0 3 2 0 2 0 1 0
0 0 0 0 0 0 0 1
0 0 1 1 3 0
0 2 0 2 0 0

50 50 50 50